1111111111111111
1001000100000C01
10E00000E0000E01
100C010000000C01
1100010000000101
1000010000C00001
1111111111111111
